################ ############
#..............###h###......#
#..............|.....|...u..#
#.......d......##############
################