################ ############
#..............###h###......#
#..............|.....|...s..#
#.......u......##############
################